14 19 10 3 5
0 0 0 0 0 0 0 0 0 0 0 0 0 0 0 0 0 0 0
0 0 0 0 0 0 0 0 0 0 0 0 0 0 0 0 0 0 0
0 0 0 0 0 0 0 0 0 1 1 1 0 0 1 1 1 0 0
0 0 0 0 0 0 1 1 1 1 1 1 0 0 6 1 1 0 0
0 0 1 1 0 0 1 0 0 1 1 1 0 0 1 1 1 0 0
0 0 1 1 1 1 1 0 0 0 3 0 0 0 0 0 0 0 0
0 0 1 1 0 0 0 0 0 0 0 0 0 0 0 0 0 0 0
0 0 0 1 0 0 0 0 0 8 0 0 0 0 0 0 0 0 0
0 0 0 1 0 0 0 0 0 1 0 0 0 0 0 0 0 0 0
0 0 1 1 1 0 0 0 1 1 1 0 0 5 1 1 0 0 0
0 0 1 1 1 1 1 1 1 1 1 1 1 1 9 1 0 0 0
0 0 1 1 1 0 0 0 1 1 1 0 0 5 1 1 0 0 0
0 0 0 0 0 0 0 0 0 0 0 0 0 0 0 0 0 0 0
0 0 0 0 0 0 0 0 0 0 0 0 0 0 0 0 0 0 0
7 9 10 3 3 15
9 13 10 11 10 12
11 13 10 11 10 12
5 10 3 7 3 8 3 12 3 13
3 14 3 7 3 8 4 4 4 5