12 17 8 5 7
0 0 0 0 0 0 0 0 0 0 0 0 0 0 0 0 0
0 0 0 0 0 0 0 0 0 0 0 0 0 0 0 0 0
0 0 0 8 0 0 0 0 0 0 0 0 1 1 1 0 0
0 0 8 1 8 0 0 7 7 1 0 0 1 9 1 0 0
0 0 0 8 0 0 0 0 0 0 0 0 1 1 1 0 0
0 0 0 0 0 0 0 0 0 0 0 0 0 0 0 0 0
0 0 0 0 0 0 0 0 0 0 0 0 0 0 0 0 0
0 0 0 0 1 1 1 0 0 0 1 1 1 0 0 0 0
0 0 0 0 1 1 1 1 1 1 1 8 1 0 0 0 0
0 0 0 0 1 1 1 0 0 0 1 1 1 0 0 0 0
0 0 0 0 0 0 0 0 0 0 0 0 0 0 0 0 0
0 0 0 0 0 0 0 0 0 0 0 0 0 0 0 0 0
8 11 2 3 3 2
2 3 2 7 2 9
4 3 3 2 4 3
3 4 3 2 3 4
3 2 3 7 3 9
3 7 3 5 3 6
3 8 3 10 3 11