14 17 8 4 2
0 0 0 0 0 0 0 0 0 0 0 0 0 0 0 0 0
0 0 0 0 0 0 0 0 0 0 0 0 0 0 0 0 0
0 0 0 0 0 0 0 0 0 0 0 0 0 0 6 0 0
0 0 0 0 0 0 0 1 1 1 0 0 1 1 1 0 0
0 0 0 0 0 0 0 1 6 1 1 1 1 1 0 0 0
0 0 0 0 0 1 1 1 1 1 0 0 1 1 0 0 0
0 0 0 0 0 1 9 1 0 0 0 0 1 1 0 0 0
0 0 0 1 1 1 1 1 0 0 0 1 1 1 1 0 0
0 0 1 1 1 1 0 0 0 0 0 1 1 1 1 0 0
0 0 1 1 1 1 0 0 1 1 1 1 1 0 0 0 0
0 0 0 0 0 0 0 1 1 1 0 0 0 0 0 0 0
0 0 0 0 0 0 0 1 1 1 0 0 0 0 0 0 0
0 0 0 0 0 0 0 0 0 0 0 0 0 0 0 0 0
0 0 0 0 0 0 0 0 0 0 0 0 0 0 0 0 0
4 8 4 14
2 14 6 8