14 18 4 6 2
0 0 0 0 0 0 0 0 0 0 0 0 0 0 0 0 0 0
0 0 0 0 0 0 0 0 0 0 0 0 0 0 0 0 0 0
0 0 0 0 0 0 0 0 0 0 1 1 1 0 0 0 0 0
0 0 0 0 0 1 1 1 0 0 1 1 1 0 0 0 0 0
0 0 1 0 0 1 1 1 1 1 1 1 1 1 1 1 0 0
0 0 1 0 0 1 1 1 0 0 0 0 0 0 6 1 0 0
0 0 1 0 0 0 0 0 0 0 0 0 0 0 1 1 0 0
0 0 1 0 0 0 0 0 0 0 0 0 0 0 1 1 0 0
0 0 1 0 0 0 0 0 0 0 1 1 1 1 1 1 0 0
0 0 1 1 1 1 1 0 0 0 1 1 1 0 0 0 0 0
0 0 0 1 1 9 1 0 0 0 1 1 1 0 0 0 0 0
0 0 0 0 1 1 1 0 0 0 1 1 1 1 1 6 0 0
0 0 0 0 0 0 0 0 0 0 0 0 0 0 0 0 0 0
0 0 0 0 0 0 0 0 0 0 0 0 0 0 0 0 0 0
11 15 5 3 5 4
5 14 4 3 4 4