14 16 7 2 1
0 0 0 0 0 0 0 0 0 0 0 0 0 0 0 0
0 0 0 0 0 0 0 0 0 0 0 0 0 0 0 0
0 0 0 1 1 1 1 0 0 0 0 0 0 0 0 0
0 0 0 1 9 1 1 0 0 0 0 0 0 0 0 0
0 0 0 1 1 1 0 0 0 0 0 0 0 0 0 0
0 0 0 1 0 0 0 1 1 1 1 1 1 0 0 0
0 0 0 1 0 0 0 1 1 0 0 1 1 0 0 0
0 0 1 1 1 1 1 1 1 0 0 1 1 1 0 0
0 0 0 0 0 0 0 1 5 0 0 0 0 1 0 0
0 0 0 0 0 0 0 1 1 1 1 0 0 1 0 0
0 0 0 0 0 0 0 1 1 1 1 1 1 1 0 0
0 0 0 0 0 0 0 0 0 0 1 1 1 0 0 0
0 0 0 0 0 0 0 0 0 0 0 0 0 0 0 0
0 0 0 0 0 0 0 0 0 0 0 0 0 0 0 0
8 8 2 6 3 6