10 19 6 3 2
0 0 0 0 0 0 0 0 0 0 0 0 0 0 0 0 0 0 0
0 0 0 0 0 0 0 0 0 0 0 0 0 0 0 0 0 0 0
0 0 0 0 0 0 0 0 1 1 1 1 0 0 1 1 1 0 0
0 0 1 1 1 1 0 0 1 1 6 1 0 0 1 9 1 0 0
0 0 1 1 3 1 0 0 1 1 1 1 0 0 1 1 1 0 0
0 0 1 1 1 1 0 0 1 1 1 1 0 0 1 1 1 0 0
0 0 1 1 1 1 0 0 1 1 1 1 0 0 1 1 1 0 0
0 0 1 1 1 1 0 0 1 1 1 1 0 0 0 0 0 0 0
0 0 0 0 0 0 0 0 0 0 0 0 0 0 0 0 0 0 0
0 0 0 0 0 0 0 0 0 0 0 0 0 0 0 0 0 0 0
4 4 6 6 6 7
3 10 6 12 6 13