12 19 5 3 1
0 0 0 0 0 0 0 0 0 0 0 0 0 0 0 0 0 0 0
0 0 0 0 0 0 0 0 0 0 0 0 0 0 0 0 0 0 0
0 0 0 0 0 0 0 0 0 0 1 1 1 1 0 0 0 0 0
0 0 0 0 0 0 0 0 0 0 1 1 1 1 0 0 0 0 0
0 0 1 1 1 0 0 0 0 0 1 0 0 1 1 1 1 0 0
0 0 1 1 1 1 1 1 1 1 1 0 0 0 1 9 1 0 0
0 0 1 1 1 0 0 0 0 1 1 6 0 0 1 1 1 0 0
0 0 1 1 1 0 0 0 0 1 1 1 0 0 1 1 1 0 0
0 0 0 1 1 0 0 0 0 1 0 0 0 0 0 0 0 0 0
0 0 0 0 1 1 1 1 1 1 0 0 0 0 0 0 0 0 0
0 0 0 0 0 0 0 0 0 0 0 0 0 0 0 0 0 0 0
0 0 0 0 0 0 0 0 0 0 0 0 0 0 0 0 0 0 0
6 11 8 5